107
8
22 4  0  0   0  0  0  0  0  0  0  0  0  0  0  0  0 0  0  0  0 0  0  0  0  0  0  0  0  0  0  0  0  0  0  0  0  0  0 0  0  0  3 22 22 22 22 22 22 22 22 22 22 22 22 22 22 22 22 22 22 22 22 22 22 22 22 22  22 22 22 22 22 22 4  0  0  0  0  0  0  0  0  0  0  0  0  0  0  3  22 22 22 22 22 22 22 22 22 22 22 22 22 22 22 22 22
22 4  0  0   0  0  0  0  0  0  0  0  0  0  0  0  0 66 0  0  0 0  0  0  0  0  0  0  0  0  0  0  0  0  77 0  0  0  0 0  0  0  0 0  18 22 22 22 22 22 22 22 22 22 22 22 22 22 22 22 19 17 17 17 17 17 17 17  17 17 18 22 22 22 22 4  0  0  66 0  0  0  0  0  0  0  0  0  0  0  0  18 22 22 22 22 22 19 17 17 17 17 17 17 17 18 22 
22 4  0  77  0  0  0  0  0  0  0  0  13 0  0  0  0 0  14 0  0 0  0  0  0  0  0  0  0  0  0  0  0  0  0  0  0  0  0 0  10 0  0 0  0  17 17 17 18 22 22 22 22 22 22 22 22 22 22 22 4  0  0  16 0  0  0  0   66 0  0  17 18 22 22 4  0  0  0  0  0  0  0  0  0  77 0  0  66 0  0  0  18 22 22 22 22 4  0  0  0  0  0  0  0  3  22 
22 4  0  0   0  0  0  0  0  0  0  0  0  77 0  11 0 0  0  0  0 0  0  0  0  0  0  77 0  0  0  0  0  0  11 0  0  0  0 23 24 25 0 0  0  0  0  0  0  17 17 18 22 22 22 22 22 22 22 19 0  0  10 0  11 0  0  0   0  0  0  0  0  17 17 0  0  0  0  9  77 0  0  0  1  21 2  0  0  0  0  0  0  18 22 22 22 4  0  0  0  0  66 0  0  3  22 
22 4  0  0   0  12 0  0  0  0  0  0  11 1  21 21 2 0  0  0  0 0  77 0  0  0  0  15 0  0  0  0  0  23 25 0  0  0  0 0  0  0  0 0  0  9  11 0  0  0  0  0  17 17 17 17 17 17 17 0  0  1  21 21 21 2  0  0   0  0  0  0  0  0  0  0  0  0  0  23 24 25 0  0  3  22 4  0  0  0  0  0  0  0  18 22 22 4  0  0  0  0  0  0  77 3  22 
22 4  0  0   0  0  0  0  0  0  1  21 21 21 6  22 4 0  0  66 0 0  10 9  0  0  0  0  0  0  10 0  0  0  0  0  0  11 0 0  77 0  0 1  21 21 21 21 2  0  0  0  9  0  0  0  0  9  0  0  0  3  22 22 22 4  0  0   0  0  0  0  0  0  0  0  77 0  0  0  0  0  0  0  3  22 4  0  0  66 0  0  0  0  0  17 17 0  0  0  0  0  0  66 0  3  22 
22 4  9  100 10 0  0  55 0  11 3  22 22 22 22 22 4 0  0  0  1 21 21 21 21 2  55 0  9  1  21 21 2  0  9  1  21 21 2 0  0  0  0 3  22 22 22 22 4  10 0  1  21 2  0  0  1  21 2  11 1  21 6  22 22 4  0  66  0  66 0  0  0  9  0  0  10 9  55 0  11 0  55 1  21 5  21 2  0  0  0  55 0  0  0  0  0  0  55  10 11 0 0  9  77 3  22 
5  21 21 21  21 21 21 21 21 21 21 6  22 22 22 22 4 0  0  0  3 22 22 22 22 21 21 21 21 21 6  5  21 21 21 21 6  22 4 0  0  0  0 3  22 22 22 5  21 21 21 21 21 21 21 21 21 21 21 21 21 6  22 22 22 4  0  0   0  0  0  1  21 21 21 21 21 21 21 21 21 21 21 21 6  22 5  21 21 21 21 21 21 21 21 21 21 21 21 21 21 21 21 21 21 21 6 
